NO txtrs/grass.xpm
SO txtrs/stone.xpm
WE txtrs/sandstone.xpm
EA txtrs/wood.xpm
F 120,200,70
C 20,100,190

111111111111
100000000001
100000000001
10000000000111111111111
10000000000000000000001
1111111000N000011111111
      1000000001
1111111000100001111111
1000000001 10000000001
100000000010000000001
11111111111111111111111
